NO ./textures/Abstract_128x128-13.png
SO ./textures/Abstract_128x128-14.png
WE ./textures/Abstract_128x128-15.png
EA ./textures/Abstract_128x128-16.png

F 56,55,55
C 160,160,160


1111111111111
111111111111
111000000011
1100S0000011
110000011111
110000011111
110011111111
110000000011
111111111111
11111111111