NO  ./textures/BlueNebula03.png
SO  ./textures/Elements0999.png
WE  ./textures/PurpleNebula04.png
EA  ./textures/Starfield08.png

C 0,0,0
F 0,0,0

111111111111111111111111111111111111111111111
100000000000000000000000000000000000000000001
100000000000000000000000000000000000000000001
100000000000000000000000000000000000000000001
100000001111111100000000000000111111000000001
100000001111111111111100000000001111111111111
111110000000000000000111111111000000000000111
1000000000000W0000000000000000000000000000011
111111111100000000000111111111111111000000011
111111111111111110000000000000000000001111111
100000000000000000000000000000000000000000001
100000000000000000000000000000000000000000001
111111111111111111111111111111111111111111111
