NO ./textures/big.png
SO ./textures/big.png
WE ./textures/brick.png
EA ./textures/brick.png

F 29,38,28
C 38,49,66

111111111111111111111111111111111111111111111111111111111111111111111111111111111111111111111111111111111
1N001
1111111111111111111111111111111111111111111111111111111111111111111111111111111111111111111111111111111111