F 0,0,0
C 179,179,179
NO ./textures/Tile07.png
SO ./textures/Tile08.png
WE ./textures/Tile11.png
EA ./textures/Tile12.png

11111
10N01
10001
11111