F 0,0,0
C 51,2,2
NO ./textures/Stone13.png
SO ./textures/Stone14.png
WE ./textures/Stone17.png
EA ./textures/Stone18.png

        11111 1111111
1111111111 1111111111111111111111111111111111111111
1000000001110000000000001
100100000000000S000000001
1111111110110000011100001
100000000011000001110111111111111
111111111111111111111111111111111111
11111111111111111111111111111111111111