F 220,100,0
C 225,30,0
NO ./path_to_the_north_texture
SO ./path_to_the_south_texture
WE ./path_to_the_west_texture
EA ./path_to_the_east_texture

        11111 1111111
1111111111 111111111111111111111111111111N1111111111
1000000001110000000000001
1001000000000000000000001
1111111110110000011100001
100000000011000001110111111111111
111111111111111111111111111111111111
11111111111111111111111111111111111111