NO ./textures/Brick10.png
SO ./textures/Brick08.png
WE ./textures/Brick14.png
EA ./textures/Brick16.png

F 29,38,28
C 38,49,66

1111111111
1000000001
1000000001
1000000001
1000S00001
1000000001
1000000001
1111111111