NO ./textures/bamboo.png
SO ./textures/water.png
WE ./textures/wood.png
EA ./textures/blackbrick.png

F 29,38,28
C 38,49,66

        1111111111111111111111111
        1000000000110000000000001
        1000000001110000000000001
        10010000000000000000000S1
111111111011000001110000000000001
100000000011000001110111111111111
11110111111111011100000010001
11110111111111011101010010001
11000000110101011100000010001
10000000000000000110000010001
10000000000000001101010010001
110000011101010111110111100111
11110111 1110101 101111010001
11111111 1111111 111111111111