11111111111
10000000001
1110N000001
10100000001
10100000001
10001000001
10000001101
10000000001
11111111111
