1111111111111111111111111111111
1000000000000000000000000000001
1000011111111111111111110000001
100001  1001          1N0000001
1000011111111111111111110000001
1000000000000000000000000000001
1111111111111111111111111111111
                              1111111111111111